Targets/Controller/Custom Devices/WL_Joystick/Triangle	Targets/Controller/Simulation Models/Models/CSE1_Oculus_gesture/Inports/ctrl_out/sixaxis/Triangle
Targets/Controller/Custom Devices/WL_Joystick/Circle	Targets/Controller/Simulation Models/Models/CSE1_Oculus_gesture/Inports/ctrl_out/sixaxis/Circle
Targets/Controller/Custom Devices/WL_Joystick/Cross	Targets/Controller/Simulation Models/Models/CSE1_Oculus_gesture/Inports/ctrl_out/sixaxis/Cross
Targets/Controller/Custom Devices/WL_Joystick/Square	Targets/Controller/Simulation Models/Models/CSE1_Oculus_gesture/Inports/ctrl_out/sixaxis/Square
Targets/Controller/Simulation Models/Models/ctrl_sixaxis2force/Outports/u_BT	Targets/Controller/Simulation Models/Models/CSE1_Oculus_gesture/Inports/ctrl_out/ctrl_sixaxis2force/u_BT
Targets/Controller/Simulation Models/Models/ctrl_sixaxis2force/Outports/u_VSP2	Targets/Controller/Simulation Models/Models/CSE1_Oculus_gesture/Inports/ctrl_out/ctrl_sixaxis2force/u_VSP2
Targets/Controller/Simulation Models/Models/ctrl_sixaxis2force/Outports/omega_VSP1	Targets/Controller/Simulation Models/Models/CSE1_Oculus_gesture/Inports/ctrl_out/ctrl_sixaxis2force/omega_VSP1
Targets/Controller/Simulation Models/Models/ctrl_sixaxis2force/Outports/omega_VSP2	Targets/Controller/Simulation Models/Models/CSE1_Oculus_gesture/Inports/ctrl_out/ctrl_sixaxis2force/omega_VSP2
Targets/Controller/Simulation Models/Models/ctrl_sixaxis2force/Outports/u_VSP1	Targets/Controller/Simulation Models/Models/CSE1_Oculus_gesture/Inports/ctrl_out/ctrl_sixaxis2force/u_VSP1
Targets/Controller/Simulation Models/Models/ctrl_sixaxis2force/Outports/alpha_VSP1	Targets/Controller/Simulation Models/Models/CSE1_Oculus_gesture/Inports/ctrl_out/ctrl_sixaxis2force/alpha_VSP1
Targets/Controller/Simulation Models/Models/ctrl_sixaxis2force/Outports/alpha_VSP2	Targets/Controller/Simulation Models/Models/CSE1_Oculus_gesture/Inports/ctrl_out/ctrl_sixaxis2force/alpha_VSP2
Targets/Controller/Simulation Models/Models/ctrl_sixaxis2thruster/Outports/u_BT	Targets/Controller/Simulation Models/Models/CSE1_Oculus_gesture/Inports/ctrl_out/ctrl_sixaxis2thruster/u_BT
Targets/Controller/Simulation Models/Models/ctrl_sixaxis2thruster/Outports/u_VSP2	Targets/Controller/Simulation Models/Models/CSE1_Oculus_gesture/Inports/ctrl_out/ctrl_sixaxis2thruster/u_VSP2
Targets/Controller/Simulation Models/Models/ctrl_sixaxis2thruster/Outports/omega_VSP1	Targets/Controller/Simulation Models/Models/CSE1_Oculus_gesture/Inports/ctrl_out/ctrl_sixaxis2thruster/omega_VSP1
Targets/Controller/Simulation Models/Models/ctrl_sixaxis2thruster/Outports/omega_VSP2	Targets/Controller/Simulation Models/Models/CSE1_Oculus_gesture/Inports/ctrl_out/ctrl_sixaxis2thruster/omega_VSP2
Targets/Controller/Simulation Models/Models/ctrl_sixaxis2thruster/Outports/u_VSP1	Targets/Controller/Simulation Models/Models/CSE1_Oculus_gesture/Inports/ctrl_out/ctrl_sixaxis2thruster/u_VSP1
Targets/Controller/Simulation Models/Models/ctrl_sixaxis2thruster/Outports/alpha_VSP1	Targets/Controller/Simulation Models/Models/CSE1_Oculus_gesture/Inports/ctrl_out/ctrl_sixaxis2thruster/alpha_VSP1
Targets/Controller/Simulation Models/Models/ctrl_sixaxis2thruster/Outports/alpha_VSP2	Targets/Controller/Simulation Models/Models/CSE1_Oculus_gesture/Inports/ctrl_out/ctrl_sixaxis2thruster/alpha_VSP2
Targets/Controller/Custom Devices/DataInput/Input3	Targets/Controller/Simulation Models/Models/CSE1_Oculus_gesture/Inports/Input/Oculus_yaw
Targets/Controller/Simulation Models/Models/CSE1_HIL_u/Outports/eta/x	Targets/Controller/Simulation Models/Models/CSE1_Oculus_gesture/Inports/Input/x
Targets/Controller/Simulation Models/Models/CSE1_HIL_u/Outports/eta/y	Targets/Controller/Simulation Models/Models/CSE1_Oculus_gesture/Inports/Input/y
Targets/Controller/Simulation Models/Models/CSE1_HIL_u/Outports/eta/psi	Targets/Controller/Simulation Models/Models/CSE1_Oculus_gesture/Inports/Input/psi
Targets/Controller/Custom Devices/DataInput/Input1	Targets/Controller/Simulation Models/Models/CSE1_Oculus_gesture/Inports/Input/Oculus_roll
Targets/Controller/Custom Devices/DataInput/Input2	Targets/Controller/Simulation Models/Models/CSE1_Oculus_gesture/Inports/Input/Oculus_pitch
Targets/Controller/Simulation Models/Models/CSE1_Oculus_gesture/Inports/Input/reset	Targets/Controller/Simulation Models/Models/CSE1_HIL_u/Inports/integrator_reset
Targets/Controller/Simulation Models/Models/CSE1_Oculus_gesture/Outports/ctrl_out/u_BT	Targets/Controller/Simulation Models/Models/CSE1_HIL_u/Inports/u/u_BT
Targets/Controller/Simulation Models/Models/CSE1_Oculus_gesture/Outports/ctrl_out/u_VSP1	Targets/Controller/Simulation Models/Models/CSE1_HIL_u/Inports/u/u_VSP1
Targets/Controller/Simulation Models/Models/CSE1_Oculus_gesture/Outports/ctrl_out/u_VSP2	Targets/Controller/Simulation Models/Models/CSE1_HIL_u/Inports/u/u_VSP2
Targets/Controller/Simulation Models/Models/CSE1_Oculus_gesture/Outports/ctrl_out/alpha_VSP1	Targets/Controller/Simulation Models/Models/CSE1_HIL_u/Inports/u/alpha_VSP1
Targets/Controller/Simulation Models/Models/CSE1_Oculus_gesture/Outports/ctrl_out/alpha_VSP2	Targets/Controller/Simulation Models/Models/CSE1_HIL_u/Inports/u/alpha_VSP2
Targets/Controller/Simulation Models/Models/CSE1_Oculus_gesture/Outports/ctrl_out/omega_VSP1	Targets/Controller/Simulation Models/Models/CSE1_HIL_u/Inports/u/omega_VSP1
Targets/Controller/Simulation Models/Models/CSE1_Oculus_gesture/Outports/ctrl_out/omega_VSP2	Targets/Controller/Simulation Models/Models/CSE1_HIL_u/Inports/u/omega_VSP2
Targets/Controller/User Channels/psi_0	Targets/Controller/Simulation Models/Models/CSE1_HIL_u/Inports/eta_0/psi_0
Targets/Controller/User Channels/x_0	Targets/Controller/Simulation Models/Models/CSE1_HIL_u/Inports/eta_0/x_0
Targets/Controller/User Channels/y_0	Targets/Controller/Simulation Models/Models/CSE1_HIL_u/Inports/eta_0/y_0
Targets/Controller/Custom Devices/WL_Joystick/PosXLeft	Targets/Controller/Simulation Models/Models/ctrl_sixaxis2thruster/Inports/PosXLeft
Targets/Controller/Custom Devices/WL_Joystick/PosYLeft	Targets/Controller/Simulation Models/Models/ctrl_sixaxis2thruster/Inports/PosYLeft
Targets/Controller/Custom Devices/WL_Joystick/PosYRight	Targets/Controller/Simulation Models/Models/ctrl_sixaxis2thruster/Inports/PosYRight
Targets/Controller/Custom Devices/WL_Joystick/PosXRight	Targets/Controller/Simulation Models/Models/ctrl_sixaxis2thruster/Inports/PosXRight
Targets/Controller/Custom Devices/WL_Joystick/Start	Targets/Controller/Simulation Models/Models/ctrl_sixaxis2thruster/Inports/Start
Targets/Controller/Custom Devices/WL_Joystick/ArrowLeft	Targets/Controller/Simulation Models/Models/ctrl_sixaxis2thruster/Inports/ArrowUp
Targets/Controller/Custom Devices/WL_Joystick/L2_cont	Targets/Controller/Simulation Models/Models/ctrl_sixaxis2thruster/Inports/L2_continuous
Targets/Controller/Custom Devices/WL_Joystick/R2_cont	Targets/Controller/Simulation Models/Models/ctrl_sixaxis2thruster/Inports/R2_continuous
Targets/Controller/Custom Devices/WL_Joystick/ArrowDown	Targets/Controller/Simulation Models/Models/ctrl_sixaxis2thruster/Inports/ArrowDown
Targets/Controller/Custom Devices/WL_Joystick/PosXLeft	Targets/Controller/Simulation Models/Models/ctrl_sixaxis2force/Inports/PosXLeft
Targets/Controller/Custom Devices/WL_Joystick/PosYLeft	Targets/Controller/Simulation Models/Models/ctrl_sixaxis2force/Inports/PosYLeft
Targets/Controller/Custom Devices/WL_Joystick/L2_cont	Targets/Controller/Simulation Models/Models/ctrl_sixaxis2force/Inports/L2_continuous
Targets/Controller/Custom Devices/WL_Joystick/R2_cont	Targets/Controller/Simulation Models/Models/ctrl_sixaxis2force/Inports/R2_continuous
